{
    "board": {
        "front": [
            "__ __ __ __ __ __ __ __",
            "__ w0 __ __ __ __ __ __",
            "__ __ __ __ __ __ __ __",
            "__ __ __ __ __ __ __ __",
            "__ __ __ __ __ __ __ __",
            "__ __ __ __ __ __ __ __",
            "__ __ __ __ __ __ __ __",
            "__ __ __ __ __ __ __ __"
        ],
        "rear": [
            "__ __ __ __ __ __ __ __",
            "__ p1 p1 p1 p1 p1 p1 __",
            "__ p1 __ __ __ __ __ __",
            "__ p1 p1 p1 p1 __ __ __",
            "__ __ __ __ p1 __ __ __",
            "__ __ p1 p1 p1 __ __ __",
            "__ w0 p1 __ __ __ __ __",
            "__ __ __ __ __ __ __ __"
        ]
    },
    "balls": [
        {
            "start": [1, 1],
            "end": [6, 6],
            "color": "yellow"
        }
    ]
} 