{
  "level": 10,
  "board": {
    "front": [
      "__ __ __ __ __ __ __ __",
      "__ __ __ __ __ __ p2 __",
      "__ __ __ __ __ __ p2 __",
      "__ __ __ __ __ __ p2 __",
      "__ __ __ __ __ __ p2 __",
      "__ p0 w0 p0 p0 p0 p0 __",
      "__ __ __ p1 __ __ __ __",
      "__ p2 p2 p0 p2 p2 p2 __",
      "__ w0 __ __ p1 __ p2 __",
      "__ __ __ __ p1 __ p2 __",
      "__ w0 __ __ p1 __ __ __",
      "__ __ __ __ p1 p1 p1 w0",
      "__ __ __ w0 __ __ __ __",
      "__ __ __ p2 __ __ __ __",
      "__ p2 p2 p2 __ __ __ __",
      "__ __ __ __ __ __ __ __"
    ],
    "rear": [
      "__ __ __ __ __ __ __ __",
      "__ __ __ __ __ __ __ __",
      "__ __ __ __ __ __ __ __",
      "p1 p1 p1 p1 p1 p1 __ __",
      "p1 __ __ __ __ p1 __ __",
      "p1 __ __ __ __ w0 __ __",
      "p1 __ __ __ __ p2 __ __",
      "p1 __ __ __ __ p2 __ __",
      "p1 p1 p1 w0 __ p2 p2 __",
      "__ w0 __ __ __ __ __ __",
      "__ p0 p0 p0 p0 __ w0 __",
      "__ __ __ __ p0 __ p2 __",
      "__ p1 p1 p1 p0 p2 p2 __",
      "__ __ __ __ __ __ __ __",
      "__ __ __ __ __ __ __ __",
      "__ __ __ __ __ __ __ __"
    ]
  },
  "balls": [
    {
      "start": [
        3,
        7
      ],
      "end": [
        4,
        8
      ],
      "color": "yellow"
    },
    {
      "start": [
        1,
        14
      ],
      "end": [
        6,
        1
      ],
      "color": "pink"
    }
  ]
}