{
  "level": 9,
  "board": {
    "front": [
      "p0 p0 p0 p0 __ __ __ __",
      "__ __ __ p0 __ __ __ __",
      "__ __ __ p0 __ __ __ __",
      "__ p0 p0 p0 __ __ __ __",
      "__ p0 __ __ __ __ __ __",
      "__ p0 p0 p0 p0 w0 __ __",
      "__ __ __ __ __ __ __ __",
      "__ __ __ __ __ __ __ __",
      "__ __ __ __ __ __ __ __",
      "__ __ __ __ __ __ __ __",
      "__ __ __ p0 p0 p0 __ __",
      "__ __ __ p0 __ __ __ __",
      "__ __ __ p0 p0 p0 p0 p0",
      "__ __ __ __ __ __ __ p0",
      "__ __ __ __ __ __ __ p0",
      "__ __ __ __ __ __ __ p0"
    ],
    "rear": [
      "__ __ __ __ __ __ __ __",
      "__ __ __ __ __ __ __ __",
      "__ __ __ __ __ __ __ __",
      "__ __ __ __ __ __ __ __",
      "__ __ __ __ __ __ __ __",
      "__ __ p0 __ __ __ __ __",
      "__ __ p0 __ __ __ __ __",
      "__ __ p0 __ __ __ __ __",
      "__ __ p0 __ __ __ __ __",
      "__ __ p0 __ __ __ __ __",
      "__ __ w0 __ __ __ __ __",
      "__ __ __ __ __ __ __ __",
      "__ __ __ __ __ __ __ __",
      "__ __ __ __ __ __ __ __",
      "__ __ __ __ __ __ __ __",
      "__ __ __ __ __ __ __ __"
    ]
  },
  "balls": [
    {
      "start": [
        0,
        0
      ],
      "end": [
        7,
        15
      ],
      "color": "red"
    }
  ]
}