{
  "board": {
    "front": [
      "p1 w0 __ p2 p2 p2 w0 __ p2 p2",
      "__ __ __ p2 __ __ __ w0 p2 __",
      "__ w0 p1 w0 __ __ __ __ __ __",
      "__ __ __ p0 p2 p2 w0 __ __ __",
      "__ __ __ w0 __ __ p1 __ __ __",
      "__ __ __ __ __ __ p1 __ __ __",
      "__ __ __ p1 p1 p1 p1 p1 w0 __",
      "__ __ __ p1 __ __ __ __ __ __",
      "w0 p2 w0 p1 __ __ __ __ __ __",
      "p2 __ __ __ __ __ __ __ __ __"
    ],
    "rear": [
      "__ __ __ p2 __ __ __ __ w0 __",
      "__ p0 w0 p2 __ __ __ __ p1 __",
      "__ p0 __ p1 p1 p1 w0 __ w0 __",
      "__ p0 p0 w0 __ __ __ __ __ __",
      "__ __ __ p1 p1 p1 w0 __ __ __",
      "__ __ __ __ __ __ p2 __ __ __",
      "__ w0 __ __ __ __ p2 __ __ __",
      "__ p1 __ __ __ __ p2 __ __ __",
      "__ p1 __ __ __ __ p2 w0 __ w0",
      "w0 p1 __ __ __ __ __ __ __ __"
    ]
  },
  "balls": [
    {
      "start": [
        0,
        0
      ],
      "end": [
        9,
        9
      ],
      "color": "red"
    },
    {
      "start": [
        0,
        9
      ],
      "end": [
        9,
        0
      ],
      "color": "purple"
    }
  ]
}